{
  "map0": [0,0,0,0,0,0,0,0,0,0,0,0,0,0,0,0,0,0,0,0,0,0,
           0,0,0,0,0,0,0,0,0,0,0,0,0,0,0,0,0,0,0,0,0,0,
           0,0,0,0,0,0,0,0,0,0,0,0,0,0,0,0,0,0,0,0,0,0,
           0,0,0,0,0,0,0,0,0,0,0,0,0,0,0,0,0,0,0,0,0,0,
           0,0,0,0,0,0,0,0,0,0,0,0,0,0,0,0,0,0,0,0,0,0,
           0,0,0,0,0,0,0,0,0,0,0,0,0,0,0,0,0,0,0,0,0,0,
           0,0,0,0,0,0,0,0,0,0,0,0,0,0,0,0,0,0,0,0,0,0,
           0,0,0,0,0,0,0,0,0,0,0,0,0,0,0,0,0,0,0,0,0,0,
           0,0,0,0,0,0,0,0,0,0,0,0,0,0,0,0,0,0,0,0,0,0,
           0,0,0,0,0,0,0,0,0,0,0,0,0,0,0,0,0,0,0,0,0,0,
           0,0,0,0,0,0,0,0,0,0,0,0,0,0,0,0,0,0,0,0,0,0,
           0,0,0,0,0,0,0,0,0,0,0,0,0,0,0,0,0,0,0,0,0,0,
           0,0,0,0,0,0,0,0,0,0,0,0,0,0,0,0,0,0,0,0,0,0,
           0,0,0,0,0,0,0,0,0,0,0,0,0,0,0,0,0,0,0,0,0,0],
  
  "map1": [0,0,0,0,0,0,0,0,0,0,0,0,0,0,0,0,0,0,0,0,0,0,
           0,0,0,0,0,0,0,0,0,0,0,0,0,0,0,0,0,0,0,0,0,0,
           0,0,2,2,2,2,2,2,0,0,0,0,0,0,3,3,3,3,3,3,0,0,
           0,0,2,0,0,0,0,0,0,0,0,0,0,0,0,0,0,0,0,3,0,0,
           0,0,2,0,0,1,1,0,0,0,0,0,0,0,0,4,4,0,0,3,0,0,
           0,0,0,0,0,1,0,0,0,0,0,0,0,0,0,0,4,0,0,0,0,0,
           0,0,0,0,0,0,0,0,0,0,0,0,0,0,0,0,0,0,0,0,0,0,
           0,0,0,0,0,0,0,0,0,0,0,0,0,0,0,0,0,0,0,0,0,0,
           0,0,0,0,0,1,0,0,0,0,0,0,0,0,0,0,4,0,0,0,0,0,
           0,0,2,0,0,1,1,0,0,0,0,0,0,0,0,4,4,0,0,3,0,0,
           0,0,2,0,0,0,0,0,0,0,0,0,0,0,0,0,0,0,0,3,0,0,
           0,0,2,2,2,2,2,2,0,0,0,0,0,0,3,3,3,3,3,3,0,0,
           0,0,0,0,0,0,0,0,0,0,0,0,0,0,0,0,0,0,0,0,0,0,
           0,0,0,0,0,0,0,0,0,0,0,0,0,0,0,0,0,0,0,0,0,0],
  
  "map2": [0,0,0,2,0,0,0,0,0,0,0,0,0,0,0,0,0,0,0,0,0,0,
           0,0,0,2,0,0,0,0,0,0,0,0,0,0,0,0,0,0,0,0,0,0,
           0,0,0,2,0,0,2,2,2,2,2,2,2,2,2,2,2,2,3,0,0,0,
           0,0,0,2,0,0,2,0,0,0,0,0,0,0,0,0,0,0,3,0,0,0,
           0,0,0,2,0,0,2,0,0,0,0,0,0,0,0,0,0,0,3,0,0,0,
           0,0,0,2,0,0,2,0,0,1,1,1,1,3,3,3,0,0,3,0,0,0,
           0,0,0,2,0,0,2,0,0,1,0,0,0,0,0,3,0,0,3,0,0,0,
           0,0,0,2,0,0,2,0,0,0,0,0,1,0,0,3,0,0,3,0,0,0,
           0,0,0,2,0,0,2,2,2,1,1,1,1,0,0,3,0,0,3,0,0,0,
           0,0,0,2,0,0,0,0,0,0,0,0,0,0,0,3,0,0,3,0,0,0,
           0,0,0,2,0,0,0,0,0,0,0,0,0,0,0,3,0,0,3,0,0,0,
           0,0,0,2,3,3,3,3,3,3,3,3,3,3,3,3,0,0,3,0,0,0,
           0,0,0,0,0,0,0,0,0,0,0,0,0,0,0,0,0,0,3,0,0,0,
           0,0,0,0,0,0,0,0,0,0,0,0,0,0,0,0,0,0,3,0,0,0],
  
  "map3": [4,4,4,4,4,4,4,4,4,4,0,0,4,4,4,4,4,4,4,4,4,4,
           4,4,4,4,4,4,4,4,4,4,0,0,4,4,4,4,4,4,4,4,4,4,
           4,4,4,4,4,4,4,4,4,4,0,0,4,4,4,4,4,4,4,4,4,4,
           4,4,4,4,4,4,4,4,4,0,0,0,0,4,4,4,4,4,4,4,4,4,
           4,4,4,4,4,4,4,4,4,0,0,0,0,4,4,4,4,4,4,4,4,4,
           4,4,4,4,4,4,4,0,0,0,0,0,0,0,0,4,4,4,4,4,4,4,
           0,0,0,0,0,0,0,0,0,0,0,0,0,0,0,0,0,0,0,0,0,0,
           0,0,0,0,0,0,0,0,0,0,0,0,0,0,0,0,0,0,0,0,0,0,
           4,4,4,4,4,4,4,0,0,0,0,0,0,0,0,4,4,4,4,4,4,4,
           4,4,4,4,4,4,4,4,4,0,0,0,0,4,4,4,4,4,4,4,4,4,
           4,4,4,4,4,4,4,4,4,0,0,0,0,4,4,4,4,4,4,4,4,4,
           4,4,4,4,4,4,4,4,4,4,0,0,4,4,4,4,4,4,4,4,4,4,
           4,4,4,4,4,4,4,4,4,4,0,0,4,4,4,4,4,4,4,4,4,4,
           4,4,4,4,4,4,4,4,4,4,0,0,4,4,4,4,4,4,4,4,4,4],
  
  "map4": [0,0,0,0,0,0,0,0,0,0,0,0,0,0,0,0,0,0,0,0,0,0,
           0,0,0,0,0,0,0,0,0,0,0,0,0,0,0,0,0,0,0,0,0,0,
           0,0,2,2,0,0,2,2,0,0,4,4,0,0,3,3,0,0,3,3,0,0,
           0,0,2,2,0,0,2,2,0,0,4,4,0,0,3,3,0,0,3,3,0,0,
           0,0,0,0,0,0,0,0,0,0,0,0,0,0,0,0,0,0,0,0,0,0,
           0,0,0,0,0,0,0,0,0,0,0,0,0,0,0,0,0,0,0,0,0,0,
           0,0,4,4,0,0,4,4,0,0,1,1,0,0,4,4,0,0,4,4,0,0,
           0,0,4,4,0,0,4,4,0,0,1,1,0,0,4,4,0,0,4,4,0,0,
           0,0,0,0,0,0,0,0,0,0,0,0,0,0,0,0,0,0,0,0,0,0,
           0,0,0,0,0,0,0,0,0,0,0,0,0,0,0,0,0,0,0,0,0,0,
           0,0,2,2,0,0,2,2,0,0,4,4,0,0,3,3,0,0,3,3,0,0,
           0,0,2,2,0,0,2,2,0,0,4,4,0,0,3,3,0,0,3,3,0,0,
           0,0,0,0,0,0,0,0,0,0,0,0,0,0,0,0,0,0,0,0,0,0,
           0,0,0,0,0,0,0,0,0,0,0,0,0,0,0,0,0,0,0,0,0,0],
  
  "map5": [0,0,0,0,0,0,4,4,4,4,4,4,4,4,4,4,0,0,0,0,0,0,
           0,0,0,0,0,0,4,4,4,4,4,4,4,4,4,4,0,0,0,0,0,0,
           0,0,0,0,0,0,0,0,0,0,0,0,0,0,0,0,0,0,0,0,0,0,
           0,0,0,0,0,0,0,0,0,0,0,0,0,0,0,0,0,0,0,0,0,0,
           0,0,0,0,0,0,4,4,4,4,4,4,4,4,4,4,0,0,0,0,0,0,
           0,0,0,0,0,0,4,4,4,4,4,4,4,4,4,4,0,0,0,0,0,0,
           0,0,0,0,0,0,0,0,0,0,0,0,0,0,0,0,0,0,0,0,0,0,
           0,0,0,0,0,0,0,0,0,0,0,0,0,0,0,0,0,0,0,0,0,0,
           0,0,0,0,0,0,4,4,4,4,4,4,4,4,4,4,0,0,0,0,0,0,
           0,0,0,0,0,0,4,4,4,4,4,4,4,4,4,4,0,0,0,0,0,0,
           0,0,0,0,0,0,0,0,0,0,0,0,0,0,0,0,0,0,0,0,0,0,
           0,0,0,0,0,0,0,0,0,0,0,0,0,0,0,0,0,0,0,0,0,0,
           0,0,0,0,0,0,4,4,4,4,4,4,4,4,4,4,0,0,0,0,0,0,
           0,0,0,0,0,0,4,4,4,4,4,4,4,4,4,4,0,0,0,0,0,0]
}